19
37
WWWWWWWWWWWWWWWWWWWWWWWWWWWWWWWWWWWWW
WWWWWWWWWWWWWWWWWWWWWWWWWWWWWWWWWWWWW
WWWWWWWWWWWWeWWeWWeWWeWWeWWeWWe_____W
WWWe5____gWWWWWWWWW_________________W
WWWW5_________________ZZC___________W
WWWe5_Z_______________T89_____CZZZ__W
WWWW5ZZ_CCC_________CCC__CCC__ZCZ.__W
WWWW723_CCCE____._.______E____0123__W
WWWWWW71111111123_0111111111116WW5__W
WWWWWWWWWWWWWWWW5L4WWWWWWWWWWWWeW5__W
WWWWWWWWWWWWWWWW5l4WWWWWWWWWWWWWW5ZCW
WWWWWWWWWWWWWWWW5l4WW5_____gWWWWW123W
WWWe5_____gWWWWW5lgWW5_________gWWW5W
WWWW5CZC______Z__l________023_______W
WWWe5ZCZ______C__l________4W723_____W
WWWW723PCCCCZ__HC___CZZE__4WWW723__ZW
WWWWWW711111111111111111116WWWWW72222
WWWWWWWWWWWWWWWWWWWWWWWWWWWWWWWWWWWWW
WWWWWWWWWWWWWWWWWWWWWWWWWWWWWWWWWWWWW





