19
37
WWWWWWWWWWWWWWWWWWWWWWWWWWWWWWWWWWWWW
WWWWWWWWWWWWWWWWWWWWWWWWWWWWWWWWWWWWW
WWWWWWWWWWWWeWWeWWeWWeWWeWWeWWe______
WWWe5____gWWWWWWWWW__________________
WWWW5________________________________
WWWe5________________________________
WWWW5________________________________
WWWW723_______________________0123___
WWWWWW71111111123L0111111111114WW5___
WWWWWWWWWWWWWWWW5l4WWWWWWWWWWWWeW5___
WWWWWWWWWWWWWWWW5l4WWWWWWWWWWWWWW5___
WWWWWWWWWWWWWWWW5l4WW5_____gWWWW7123_
WWWe5_____gWWWWW5lgWW5_________gWWW5_
WWWW5____________l________023________
WWWe5_____________________4W723______
WWWW723P__________________4WWW723____
WWWWWW788888888888888888886WWWWWW____
WWWWWWWWWWWWWWWWWWWWWWWWWWWWWWWWWWWWW
WWWWWWWWWWWWWWWWWWWWWWWWWWWWWWWWWWWWW





